+-----------+---+-+-----+
|S          |   | |     |
| | +---+-- | | | +-- --+
| | |   |     | |       |
| | | | +-----+-+---- | |
| |   | |             | |
| +-+-+-+ | +-+ +-+---+ |
|   |     | | | | |     |
| | | +-+-+ | | | +-----+
| | | | | | | | |       |
| +-+ | | | | +-+ ----+ |
| |     | |     |     | |
| +-- --+ | ----+ +-- | |
|       |         |   |X|
+-------+---------+---+-+
