+--------------+--------------------+
|S             |                    |
| +------------+------------------- |
| |                                 |
| +-------------- ------------+ --+ |
| |                           |   | |
| | +-----------------+-+ --+ | --+ |
| | |                 | |   | |   | |
| +-+------ --------+ | | +-+ | +-+ |
| |                 | | | |   | | | |
| | ----------------+ | +-+-- | | | |
| |                 | |       | | | |
|   +-----+-+ | +---+ +------ +-+ | |
| | |     | | | |     |       |   | |
| +-+---+ | | | | ----+---+-+-+---+ |
| |     | | | | |         | |       |
| | +-- | | | | | --------+ +------ |
| | |   | | | | |         |         |
| | +---+ | +-+-+ +-------+ | +---- |
| |               |       | | |     |
| +-------------+ | ------+ | | --+ |
|               | |         | |   | |
+---------------+ +---------+ +-- | |
|                 |           |   | |
| +---+---+---+---+ +-+-+-----+   | |
| |   |   |   |   | | | |         | |
| | | | | | | | | | | | +-- ------+ |
|   |   |   |   |   |             |X|
+---+---+---+---+---+-------------+-+
